R 1920 1080
NO textures/wall_1.xpm
SO textures/wall_2.xpm
WE textures/wall_3.xpm
EA textures/wall_4.xpm
S textures/sprite_text.xpm
F 184,113,39
C 51,198,227

11111111111111111111111111111
10000000001100000000000000001
10110000011102000000000010201
10010000000000000000000010001
10110000011100000000000010001
10000000001100000111011110001
11110111111111011100000010001
11110111111111011101010010001
11000000110101011100000010001
10002000000000001100000010001
10000000000000001101010010001
11020000110101000000000000001
11110111110101000000000000001
10000000001100000100200010001
10000000000000001010000101001
10200000001000010001010001001
10000000001101000200N00200201
10000000000100000001010000001
11111111111111111111111111111
