R 848 480
NO textures/skekwegn.xpm
SO textures/sky_1.xpm
WE textures/sky_1.xpm
EA textures/sky_1.xpm
S textures/sprite_1.xpm
F 184,113,39
C 51,198,007
1111111111111111111111111111111111111111111
1000000000110000000000000000010000000000001
1011000001110000000000001000000000000000001
1001000000000000000000001001110000001111101
1011000001110000000000001000100011111111101
1000000000110000011101111000100000000000001
1111011111111101110000001000100000000000001
1111011111111101110101001000100000000100001
1100000011010101110000001000100000000000001
1000000000000000110000001000100000000000001
1000000000000000110001000000100100000000001
1100000011010100000000000000100000000100001
1111011111010100000000000000100000000000001
1000000000110000010000001000100000000000001
1000000000000000000000000100100000000000001
1000000000100001000000000100100000100000001
1000000000110100000000000000100000000000001
10000000000100000001N1000000100000000100001
1000000000010000000101000000100010000000001
1000000000010000001101011111100000000000001
1000000000010000000001000000000000000000001
1011111111111111111111111111111111111101111
1000111111111111111111111111111111111101111
1110000111111111100000000011111111110001111
1110000011111111101111110000011111110111111
1110000011111110000000111110000111110111111
1111110011111110111100111111000111110111111
1111110000000000111100001111000000000111111
1111110000000000111111000000001111100111111
1111100111111111111111111111111111100000011
1111101111111111111111111111111111111001111
1111101111111111111111111111111111111001111
1111101111111111111111111111111111111001111
1111101111111111111111111111111111111001111
1111101111111111111111111111111111111001111
1111100000000000000000000000000000000001111
1111101111111011111110111110111011111001111
1111100000000000000000100000000000000001111
1111100000000000100000010000000000000001111
1111100000000000100000001000000000000001111
1111101111111111111111100011111111111001111
1111100000000000000000000011111111111001111
1111111111111111111111111111111111111001111
1111101111111111111111111111111111111001111
1111101111111111111111111111111111111001111
1000000000110000000000000000010000000000001
1011000001110000000000001000000000000000001
1001000000000001100000001001010000001011011
1011000001000000000000000100010000111011001
1000000000110000010101111000111100000000001
1111011100001110110000100001111110000000001
1111011111111101110101001000100000000100001
1100000011010100000000001000000000000000001
1000000000000000110000001000100000000000001
1000000000000000110001000000000100000000001
1100000011010100000000000000100000000110001
1111011101010100000000000000000000000110001
1000000000110000010000001000111000000000001
1000000000000000000000000100111000010000001
1000000000100001000000000100100000110000001
1000000000000100000000000000000000010000001
1000100000000000000101000000100000000100001
1000110000000000000100000000000010000000001
1000000000000000001100011111100000000000001
1000000000000000000000000000000000000000001
1000000000000000000000000000000000000000001
1000000000000000000000000000000000000000001
1000000000000000000000000000000000000000001
1000000000000000000000000000000000000000001
1000000000000011100000000000000000000000001
1000000000000011100000000000000000000000001
1000000000000000000000000000000000000000001
1000000000000000000000000000000000000000001
1000000000000000000000000000000000000000001
1000000000000000000000000000000000000000001
1000000000000000000000000000000000000000001
1000000000000000000000000000000000000000001
1010101010101010101010101010101010101010101
1010101010101010101010101010101010101010101
1000000000000000000000000000000000000000001
1000000000000000000000000000000000000000001
1000000000000000000000000000000000000000001
1001010101010101010101010101010101010101011
1000000000000000000000000000000000000000001
1000000000000000000000000000000000000000001
1010101010101010101010101010101010101010101
1000000000000000000000000000000000000000001
1000000000000000000000000000000000000000001
1001010101010101010101000101010101010101011
1001000101010101010101000101010101010101011
1010101010101010101010101010101010101010101
1001010101010101010101000101010101010101011
1000000000000000000000000000000000000000001
1000000000000000000000000000000000000000001
1000000000000000000000000000000000000000001
1111111111111111111111111111111111111111111
