R 800 800
NO texture/metal.xpm




SO texture/redbrick.xpm
























WE texture/colorstone.xpm
EA texture/greystone.xpm
S texture/greenlight.xpm
F 0,0,0

C 0,0,0
1111111
1000001
100S001
1000001
1002001
1002001
1002001
1111111
