R 848 480
NO texture/tex_no
SO texture/tex_su
WE texture/tex_we
EA texture/tex_ea
S textures/sprite_1.xpm
F 184,113,39
C 51,198,007
111111111111111111111111111
100000000000000000000000001
101111111110000000000000001
101000000010000111101111101
1N1000000010000100100010001
101000000010000100100010001
101000011111110100100010001
101000000000000100111110001
101000000000000100000000001
101111100000011100000000001
100000100010010000000000001
101010100011110000000000001
100000100000100000000000001
101010100111100000000000001
100000100100000011001100001
101111100100000011001100001
100000000100000000000000001
100000000100000000000000001
100000000100000011001100001
101010000000000011001100001
101010000000000000000000001
111011000000000000000000001
100001000000000000000000001
111111111111111111111111111
