R 900 900
NO texture/metal.xpm
SO texture/redbrick.xpm
WE texture/colorstone.xpm
EA texture/greystone.xpm
S texture/greenlight.xpm
F 0,0,0
C 0,0,0
1111111111111111111111111111111111111111111
1000000000110000000000000000010000020000001
1011000001110000200000001000000000000000001
1001020000000000000000001001110000001111101
1011000001110000000000001000100011111111101
1000000000110000011101111000100000000000001
1111011111111101110000001000100000000000001
1111011111111101110101001000100020000100001
1100000011010101110000001000100000000000001
1000000000000000110000001000100000000000001
1000200000000000110002000000100100000000001
1100000011010100000000002000100000000100001
1111011111010100000000000000100020000000001
1000000000110000010000001000100000000000001
1000000000000000000000000100100000000002001
100000000010000100N000000100100000100000001
1000000000110100000000000000100000000000001
1000020000010000000101002000100000000100001
1000000000010000000101000000100010000000001
1000000000010000001101011111100000002000001
1000000000010000000001000000000000000000001
1111111111111111111111111111111111111111111
