R 848 480
NO texture/tex_no
SO texture/tex_su
WE texture/tex_we
EA texture/tex_ea
S textures/sprite_1.xpm
F 184,113,39
C 51,198,007
1111111111111111111111111111111111111111
1000000000000000000000000000000000000001
1010000000000111000000000000000000000001
1000000000000000000000000000000000000001
1000000000011000000000000000000000000001
1000000000011000000001100000000110000001
1000000000000000000001100000000110000001
1000000000011000000N00000000000110000001
1000000000000000000000000000000110000001
1000000000000000110000000000000000000001
1000000000000000110000000000000000000001
1000000110000000000000000000001100000001
1000000110000000000000000000001100000001
1000000000000000000000000000000000000001
1111111111111111111111111111111111111111
